R 800 600


NO ./img/north.xpm


   SO ./img/south.xpm
WE    ./img/west.xpm
  EA    ./img/east.xpm
S ./img/barrel.xpm

F 255,123,20
C 255,200,245

        1111111111111111111111111
        1000000000110000000000001
        1011000001110000002000001
        1001000000000000000200001
111111111011020001110000002000001
100000000011002001110111111111111
11110111111111011100000010001
11110111111111011101010010001
11200000110101011100000010201
10000E20000000001100000000201
10000020000000001101010010201
1122000111010101111101111010111
11110111 1110101 101111010001
11111111 1111111 111111111111